....................
....................
..........X.........
.......######.......
..°..............°..
####..°.°.°.°....###
.......°.°.°C°......
......--------......
....-...........-...
....................
.°.°............°.°.
####............####
....................
.1..................
####################
