....................
...°............X...
...--..°.......--...
....°.--........°...
...--..........--...
...°......°....°....
...--....--....--...
....°...........°...
...--........°.--...
...°........--.°....
...--..........--...
....°...........°...
...--..........--...
.1..................
####################
